############################################################
##################################### ######################
###  # #     ## #  ####  ####      ##     # ###  ###########
##   #      #    #  ###   ## # P    # #       #   ##########
## #     #   ## ###             # ##  ## # # ### #   #######
###  #  # # #   ####   ## # #   ##  #  # ##   #    ##  #####
## #  #          #### # ### #  #  #   ##    # #  #        ##
##  #  #   #   #   ##    ## #       # #  # #    #    # #  ##
###  #  ###  #  #  #  ###  #  #   #          # #  #   ######
####   # # #  # ##   ### #  #       # ##     #   ####  #####
##### ##     # #   #  #      #  # #     ##  #     # ########
## #       #    # #    # ## #  #  #### ####  # # #   ### # #
#      #   # #   #         # # # ###  #####   # # # # #  # #
##    ## # #  ## #      # #   # K # #  # ###  #            #
### # #      ##      ##   ## #### # # ## ####   ### #   # ##
#### #   #  ## # # #          #           ##  #   # ## #  ##
###   ##  # #     #    #    #   ## # #  #    ## #  # #   ###
##  #     # # ## ###  #  # #>#   # #  # # #    # #     #  ##
###### ##   ##   ##  #  #       #   #       ####  # ##  ####
##     #  #  ##    #   ### #  #  ##  #  ###     # ##########
### # ##  # #    #  # ###    #  #  # # ##### ##    #  ######
##     #  #  # # # #  ## ##       #  #   ###   ## ## #######
##  # #  ### # ###   ##      #   #     #  #  #  ##    ######
## #      # #   #  #    # #  # #   ## #     #  # #  #  #####
##   ## # # # ## ## ##    ##  #  ##    #   # #       #######
#  #   #  #           #### #   #    # ####   ## ##    ######
##### ####  # ### #### #     #  # # ##  # ##### ### # ######
####  ## #       #       # #  # # #    ##  #######  # ######
####      # # ##   # # ###      #### #     ########  #######
############################################################
