############################################################
########### # ########### ##################################
##  # #         ##        #  # # #    ##   ###   ###########
## #    # ##      #     #          ## #         #  #########
##  # #  #####         ### ##   ### #   #    #    # ########
## ## # # # ## ### # ###      # #    ###    #  ##   ########
## # #          ##    # # # ##    # #        ###############
##    # # # ###  # # #   #  # # ##   ##  #   # ### #########
###   ## ## # ###   ## ##        ## # # #  ##    # #########
#        ##     # #           ##    # #      # #   #########
### # #     ## #  # # # ### ## # #      # ##   ### #########
##  ###  ##      # #     #  #    #   # ##  ###   # #########
## #    #   # # #     #   # # ##    ## #  #### # #   #######
### ##   ## #   # ## #  ##   #####  #   ### ## ##   ########
###   #   ##   #   #  #    #  ##  ##   ##             ######
## # #K#  # #  ##    #  #   ### # #      # ### # # # #######
##     #       #      # ###  #     # #     #  ## # # #######
## ## #  #  # #   #       # # ## # #   # #     #     #######
###   ##           # # ##   # #   #  #  # # #     # ########
##  #> ###### ### #  #  # ##    ##  ###    ###  # # ########
##     #         ##   #  #  # ##  # #### #   # #   #########
##  #    # ## ###### ## #  #     ##   ## # #     #  ##### ##
#### ### # #     ## # #       ###   # # #     ###### # ## ##
###       #   ##       #   ##            # #   # #     ## ##
##  # # #   ##   ### ##  #   # ##      #  # #      # #     #
#     ##     ## ##   # #      ###  #  #  #  #  # # #  #  # #
### #    # #   ###      ##   # #      # # # # #  #   # P  ##
##     ##  ##  ### # #      ##   # # ##        ##  #  #    #
## # #####  #        ######   #  #       # ##   #   # # # ##
############################################################
